NO img/north_txtr.xpm



SO img/south_txtr.xpm


WE img/west_txtr.xpm

C 100,100,255


EA img/east_txtr.xpm


F 250,250,200



                                                 11111111111
11111                                            10000000001
10001                                 1111111111110000000001
100011111111111                      10000000000000001000001
10000000000000111111111111111111     10000000000000001000001
100000000000001000000000000000001    10000000000000001000001
10000000000000100000000000000000111111000011111111111100000111
1000000000000000000000000000000000N000000000000000000000000001
10000000000000000000000000000000000000000000000000000000000001
10000000000000111111111111110000111111110011111111111100000001
100000000000001            100001      1001          100000001
111100111100001            100001      1001          100000111
   1001  100001            100001      1001          1000001
   1001  111111            100001      1001          1000001
   1001          11111111111100111111111001          1000001
111100111111     10000000000000000000000001          1000001
1000000000011111110000000000000000000000001          1000001
1000000000000000000011111111100001111111111          1000001
100000000000000000001       100001                   1000001
111111110011111111111       100001         11111111111000001
       1001                 100001         100000000000000011111
       1001                 100001         100000000000000000001
       1001                 100001         100000000000000000001
       1001                 100001         100011111000000000001
   111110011111             10000111111111110001   1000000000001
   100000000001             10000000000000000001   1000000000001
   1000000000001            10000000000000000001   1000000000001
   1000000000001            10011111110000000001   1000000000001
   1000000000001            10011111110000000001   1000111111111
   100000000001             10011111110000000001   11111
   100000000001 11111       10011111110000000001
   100000000011111001       10011111110000000001
   100000000000000001       10011111110000000001
   100000000000000001111111110000000000000011111
   10000000000000000000000000000000000000001
   10000000000000000000000000000000000000001
   11111111111111111111111111111111111111111


                




















































