
F 0,0,0
C 0,0,0

NO img/bedrock.xpm

SO img/bedrock.xpm

WE img/meeseeks.xpm

EA img/bulletchar.xpm
111111111111111111111
1000000000000N000000001
1111111111111111111111