
F 0,0,0
C 0,0,0

NO img/bedrock.xpm

SO img/bedrock.xpm

WE img/meeseeks.xpm

EA img/bulletchar.xpm

111111111111 1111111111
1000000000001N000000001
10000000000000000000001
10000000000000000000001
10000000000000000000001
10000000000111000000001
100000000001 1000000011
100000000001 1000000001
100000000001 1000000001
11111111111111111111111