NO img/bedrock.xpm

SO img/bedrock.xpm

WE img/meeseeks.xpm

EA img/bullet.xpm

F 200,204,100
C 200,200,0



1111111111111111111111111111111111111111111111
100N000000110000000000001
101100000111000000000000111111
10010000000000000000000011111
111111111011000001110000111111
100000000011000001110111111111
111101110011000011100000010001
111101110000000111010000010001
110000001100000111000000010001
100000000000000000000000000001
100000000000000000000000000001
110000011101010111111111000011
111101111111010111111110000011
111111111111111111111111111111
