EA img/bulletchar.xpm

SO img/catt.xpm

WE img/vicecity.xpm

NO img/17.xpm

F 255,152,255
C 50,12,15



1111111111111111111111111
100S000000110000000000001
10110000011100000000000011111
10010000000000000000000011111
111111111011000001110000111101
100000000011000001110111111101
111101110011000011100000010001
111101110000000111010000010001
110000001100000111000000010001
100000000000000000000000000001
100000000000000000000000000001
100000000000000000000000000001
100000000000000000000000000001
110000011101010111111111000011
111101111111010111111110000011
111111111111111111111111111111