NO img/north2.xpm

SO img/south2.xpm

WE img/west2.xpm

EA img/east2.xpm

F 200,204,100
C 200,200,0

EA SPORTS ITS IN THE GAME

111111111111111111111111111111111111111111111111
1000000000110000000000001
101100000111000000000000111111
10010000000000000000000011111
111111111011000001110000111111
100000000011000001110111111111
111101110011000011100000010001
111101110000000111010000010001
110000001100000111000000010001
100000000000E00000000000000001
100000000000000000000000000001
110000011101010111111111000011
111101111111010111111110000011
111111111111111111111111111111
